#############-----#############
#-----------------------------#
#-----------------------------#
#-----------------------------#
#----#-------------------#----#
#----#-------------------#----#
#----#-------------------#----#
#----#####################----#
#-----------------------------#
#-----------------------------#
#-----------------------------#
#-----------------------------#
#-----------------------------#
#-----------------------------#
-------------------------------
---------------s---------------
-------------------------------
-------------------------------
-------------------------------
#-----------------------------#
#-----------------------------#
#-----------------------------#
#-----------------------------#
#-----------------------------#
#-----------------------------#
#----#####################----#
#----#-------------------#----#
#----#-------------------#----#
#----#-------------------#----#
#-----------------------------#
#-----------------------------#
#-----------------------------#
#############-----#############